Von Storm - Mad Af
Dispersiones Sonoras - Del Mar Hasta la Cordillera
DVRST, Igor Sklyar & Atomic Heart - Komarovo (DVRST Phonk Remix)
Truffel the Phunky Phaqir - Watch Out (feat. Ellmatic)
Edwin Rosen - Verschwende deine Zeit
TEENAGE PUNK - Safe Call
Jidanofu & Pozle - BDA (D A Y Remix)
SLEEPYHΞAD & SH3TLVIZ - EMOTIONAL OUTBURST
CRISTALLIN - Talking To the Sun
Shelter 12 & Benjamin Amaru - Turn Off Your Mind
Steven Mudd - Letters
Far Caspian - July
easy life - have a great day
Matt Duncan - The Keys
Edwin Rosen - leichter//kälter
RIP SLYME - Don't Panic (Ugly Duckling Remix)
EKKSTACY - it only gets worse, i promise
Satellite Stories - Kids Aren't Safe in the Metro (Voyeurist Remix)
Zmeyev, Inownlove & Phlocalyst - Vibin in Сafé
Yung Saddy - Night Kyoto
FLAYA PLAYA - EBASHI
Infinite Phoenix - Za Warudo
okayceci - feel u
Engelwood & iamalex - Moon Waltz
Parks, Squares and Alleys - I Love You
Стул Сталина - Лэп
SWMRS - Trashbag Baby
kqeJo & 37R - Oh Heart
Birocratic, Brock Berrigan, iamalex & Philanthrope - Brockoli
finesse scar - Scope
Edwin Rosen - "1119"
Mohammed Irfan - Aami Sudhu Cheyechi Tomay
Sipper - Bite
iogi - everything's worth it
Summer Salt - Fire Flower
MIDICRONICA - San Francisco
Joji - Medicine
Polo High - Ex-
Todd Terry - Jumpin'
Theysayjohn - Up N Down Radioactive
Jetpacc - Gas Like Citgo
Takuro Yoshida - Jun
Nick Efremov - Несмышлёный
Komiko - Feel Alright
Matatabi - Thet Remind Me
Acid Ghost - Mistakes
Caius - Sweet Days
Miksu / Macloud & makko - Nachts wach
boy pablo - Losing You
Aidan Bissett - More Than Friends
not dvr - muscles
Achim Funk & Mr.Nylson - The Flava Queen
Arc De Soleil - Strolling Sloth
The Growlers - Try Hard Fool
Yxngxr1 - Rather Do
Saint Petersburg Disco Spin Club - Can't You See Me
Falling Majesties - By Panthon
Palace - Live Well
BRANDENBURG - Holy Places
Lorenzo Chi - Deep Sky
Saib - Mint Jam
Panthurr - RayDeeO (feat. Brock Berrigan)
The Drums - What You Were
Spoiled Suede - Cream Pies & Seltzer Bottles
Day Wave - Nothing at All
[bsd.u] - Bebop
Yot Club - Landlord
Beach Fossils - May 1st
Video Age - Days to Remember
